ITA06-Machine Learning 
List of Lab Exercises
EXPERINMENT 1	Implement and demonstrate the FIND-S algorithm for finding the most specific hypothesis based on a given set of training data samples. 
EXPERINMENT 2	For a given set of training data examples stored in a .CSV file, implement and demonstrate the Candidate-Elimination algorithm in python to output a description of the set of all hypotheses consistent with the training examples
EXPERINMENT 3	Demonstrate the working of the decision tree based ID3 algorithm. Use an appropriate data set for building the decision tree and apply this knowledge to classify a new sample.
EXPERINMENT 4	Build an Artificial Neural Network by implementing the Backpropagation algorithm and test the same using appropriate data sets.
EXPERINMENT 5	Write a program for Implementation of K-Nearest Neighbours (K-NN) in Python
EXPERINMENT 6	Write a program to implement Na√Øve Bayes algorithm in python and to display the results  using confusion matrix and accuracy.
EXPERINMENT 7	Write a program to implement Logistic Regression (LR) algorithm in python
EXPERINMENT 8	Write a program to implement Linear Regression (LR) algorithm in python
EXPERINMENT 9	Compare  Linear and Polynomial Regression using Python
EXPERINMENT 10	Write a Python Program to Implement Expectation & Maximization AlgorithmAPPLICATIONS
EXPERINMENT 11	Write a program for the task of Credit Score Classification
EXPERINMENT 12	Implement Iris Flower Classification using KNN
EXPERINMENT 13	Implement the Car Price Prediction Model using Python
EXPERINMENT 14	Implement House price Prediction using appropriate machine learning algorithm
EXPERINMENT 15	Implement Iris Flower Classification using Naive Bayes classifier
EXPERINMENT 16	Compare different types Classification Algorithms and evaluate their performance.
EXPERINMENT 17	Implement Mobile Price Prediction using appropriate machine learning algorithm
EXPERINMENT 18	Implement Perceptron based IRIS classification
EXPERINMENT 19	Implementation of Naive Bayes classification for Bank Loan prediction
EXPERINMENT 20	Implement Future Sales Prediction using a suitable machine learning algorithm